
EA ./pictures/candy_land/unicorn.png
WE ./pictures/candy_land/donut.png
NO ./pictures/candy_land/ice_cream.png
SO ./pictures/candy_land/lollipop.png

F 255, 105, 180
C 225, 0, 127


        1111111111111111111111111
        1000000000110000000000001
 11111111011000001110000000000001
100100000000000000000000111111111
111111111011000001110000000000001
100000000N110000011101111111111111111
11110111111111011100000010001
11110111111111011101010010001
1100000011010101110000010001
10000000000000001100000010001
10000000000000001101010001
110000011101010111110111100111
11110111 1110101 101111010001
11111111 1111111 111111111111
