NO ./pictures/emotions/surprised.png
EA ./pictures/emotions/happy.png
SO ./pictures/emotions/smirk.png
WE ./pictures/emotions/sad.png

C 65, 207, 254    
F 23,170,250

111111111111111111111111
100000000000000000000001
100000000110011000000001
100000001001100100000001
100000000100001000000001
100000000010010000000001
100000110001100011000001
100000100000000001000001
100000100000000001000001
100000100000000001000001
100000100000000001000001
100000100000000001000001
100000100000000001000001
100000100000000001000001
100000100000000001000001
100000111111111111000001
100000000000000000000001
100000000000000000000001
100000000000000000000001
111111111100011111111111
100000000000000000000001
10000000000000000000001
10000000000N000000000001
100000000000000000000001
111111111111111111111111
