EA ./pictures/candy_land/unicorn.png
WE ./pictures/candy_land/donut.png
NO ./pictures/candy_land/ice_cream.png
SO ./pictures/candy_land/lollipop.png
F 255, 105, 180
C 225, 0, 127

11111111111111111111111111111111111111111111111111111111111111111111111111111111111111111111111111111111111111111111111111111111111111111111111111111111111111111111111111111111111111111111111111111111
1000000000000000000000000000000000000000000000000000000000000000000000000000000000000000000000000000000000000000000000000000000000000000000000000000000000000000000000000000000000000000000000000000W001
11111111111111111111111111111111111111111111111111111111111111111111111111111111111111111111111111111111111111111111111111111111111111111111111111111111111111111111111111111111111111111111111111111111