NO ./pictures/paris_the_chihuahua/paris.png
EA ./pictures/paris_the_chihuahua/champagne.png
SO ./pictures/paris_the_chihuahua/golden_pilar.png
WE ./pictures/paris_the_chihuahua/gold_glitter.png

F 218,165,32
C 255,255,255

111111
100001
100001
100001
100001
100001
100N01
111111
