F 0, 255, 85
C 0, 0, 255   

SO ./pictures/wolf_textures/mossy.png
EA ./pictures/wolf_textures/purplestone.png
WE ./pictures/other_textures/new-us.png
NO ./pictures/other_textures/new-us.png 



1111111111111111111111111
1000000000000000000000011
1010000000011000001000001
1000000011111100000101111
1111100000000001111101001
1000000110111100000110001
1111011110100011111000111
1111011110001111011110001
1000000001000010000001111
1000000000000000000000011
1000000000000000000000001
1011111111111111111111111
1000111110000011111111111
1110001111110010000010001
1111000000000011110010001
1000000110110000000110001
1111011110100011111000111
1000000000000000000000001
1000000000000000000000001
1000000000010000000000001
1000000000000000000000001
1000000000000000000000001
1000000000N00000000000001
1000000000000000000000001
1111111111111111111111111