NO ./pictures/other_textures/diamond.png



SO ./pictures/other_textures/gold.png



WE ./pictures/other_textures/stone.png


EA ./pictures/animal_print/cow.png

F 0,0,255
C 255,0,0

1111111
1N00001
1000001
1111111







