NO ./pictures/other_textures/diamond.png



SO ./pictures/other_textures/gold.png



WE ./pictures/other_textures/stone.png


EA ./pictures/other_textures/wood.png

F 0,0,255
C 255,0,0

1111
1N01
1111