NO ./pictures/animal_print/leopard.png
EA ./pictures/animal_print/zebra.png
SO ./pictures/paris_the_chihuahua/gold_glitter.png
WE ./pictures/paris_the_chihuahua/chandelier.png

F 255, 113, 233
C 225, 255, 255

111111111111111
100000000000001
101000000000001
100100011111111
111100000000001
100000011111111
111101111110001
111101111000111
110000000100001
1000000W0110001
100000001011001
110000011100111
111011111100111
100000011111111
111111111111111